wrk	work
grl	girl
ths	this
whts	whats
thnx	thanx
wldnt	wouldnt
bck	back
btwn	between
cld	could
cldnt	couldnt
dnt	dont
dwn	down
fck	fuck
fckn	fuckin
frm	from
frnds	friends
grt	great
gvt	govt
hrs	hours
jnr	junior
kll	kill
lvl	level
mch	much
mnths	months
nvr	never
nxt	next
ppls	peoples
pwr	power
shld	should
sht	shit
snr	senior
srs	serious
thm	them
thnk	thank
thnks	thanks
tht	that
thts	thats
tmp	temp
txt	text
txts	texts
whn	when
wht	what
wknd	weekend
wks	weeks
wld	would
